####################
#                 @#
#                  #
#  ##############  #
#  ##    @     ##  #
#  ##          ##  #
#  ##          ##  #
#  ##          ##  #
#  ##          ##  #
#  ##          ##  #
#  ##          ##  #
#  ##          ##  #
#  ##          ##  #
#  ########## ###  #
#                  #
####################
;