##########
#      # #
#      # #
###    # #
#      # #
#      # #
#      # #
#        #
#X       #
##########
;