##########################################################################################################################################################################################
##########################################################################################################################################################################################
##              ##########          ########                                                            X                                                                             ####
##              ##                        ##                                                                                                                                          ####
##              ##                        ##                                                                                                                                          ####
##              ##                        ##                                                                                                                                          ####
##              ##                        ##                                                                                                                                          ####
##              ##                        ##                                                                                                                                          ####
##              ##                        ##                                                                                                                                          ####
##              ##                        ##                                                                                                                                          ####
##              ##                        ##                                                                                                                                          ####
##              ##                        ##                                                                                                                                          ####
##              ##                        ##                                                                                                                                          ####
##              ##                        ##                                                                                                                                          ####
##              ##                        ##                                                                                                                                          ### 
##              ##                        ##                                                                                                                                          ### 
##              ##                        ##                                                                                                                                          ####
##              ##                        ##                                                                                                                                          ####
##              ##                        ##                                                                                                                                          ####
##              ##                        ##                                                                                                                                          ####
##              ##                        ##                                                                                              ######################                      ####
##              ##                        ##                                                                                                                                          ### 
##              ##                        ##                                                                                                                                          ### 
##              ##                        ##                                                                                                                                          ####
##              ##                        ##                                                                                                                                          ####
##              ##                        ##                                                                                                                                          ####
##              ##                        ##                                                                                                                                          ####
##              ##                        ##                                                                                                                                          ####
##              ##                        ##                                                                                                                                          ####
##              ##                        ##                                                                                                                                          ####
##              ##                        ##                                                                                                                                          ####
##              ##                        ##                                                                                                                                          ####
##                                        ##                                                                                                                                          ####
##                                        ##                                                                                                                                          ####
##                                        ##                                                            ##############      ##################################      ######################
##                                        ##                                                            ##############      ##################################      ######################
##                                        ##                                                                                                                                          ####
##                                        ##                                                                                                                                          ####
##              ##                                                                                                                                                                    ####
##              ##                                                                                                                                                                    ####
##################                                                                                                                                                                    ####
##################                                                                                                                                                                    ####
##              ##                                                                                                                                                                    ####
##              ##                                                                                                                                                                    ####
##                                                                                                                                                                                    ####
##                                                                                                                                                                                    ####
##                                        ##                                                                                                                                          ####
##                                        ##                                                                                                                                          ####
##                                        ##                                                            ##############      ########################      ################      ##########
##                                        ##                                                            ##############      ########################      ################      ##########
##              ##                        ##                                                                                                  ##                #                     ####
##              ##                        ##                                                                                                  ##                #                     ####
##              ##                        ##                                                                                                  ##                #                     ####
##              ##                        ##                                                                                                  ##                #                     ####
##              ##                        ##                                                                                                  ##                #                     ####
##              ##                        ##                                                                                                  ##                #                     ####
##              ##                        ##                                                                                                  ##                #                     ####
##              ##                        ##                                                                                                  ##                #                     ####
##              ##                        ##                                                                                                  ##                #                     ####
##              ##                        ##                                                                                                  ##                #                     ####
##              ##                        ##                                                                                                  ##                                      ####
##              ##                        ##                                                                                                  ##                                      ####
##              ##                        ##                                                                                                  ##################                      ### 
##              ##                        ##                                                                                                  ##################                      ### 
##              ##                        ##                                                                                                  ##                                      ####
##              ##                        ##                                                                                                  ##                                      ####
##              ##                        ##                                                                                                  ##                                      ####
##              ##                        ##                                                                                                  ##                                      ####
##              ##                        ##                                                                                                  ##                                      ### 
##              ##                        ##                                                                                                  ##                                      ### 
##                                        ##                                                                                                  ##                                      ####
##                                        ##                                                                                                  ##                                      ####
##                                        ##                                                                                                  ##                                      ####
##                                        ##                                                                                                  ##                                      ####
##              ##                        ##                                                                                                  ##                                      ####
##              ##                        ##                                                                                                  ##                                      ####
##              ##                        ##                                                                                                  ##                                      ####
##              ##                        ##                                                                                                  ##                                      ####
##              ##                        ##                                                                                                  ##                                      ####
##              ##                        ##                                                                                                  ##                                      ####
##              ##                        ##                                                                                                  ##                                      ####
##              ##                        ##                                                                                                  ##                                      ####
##########################        ########################################################################################################################################################
##########################        ########################################################################################################################################################
;