####################
#                  #
#                  #
#  ##############  #
#  ##    @     ##  #
#  ##          ##  #
#  ##          ##  #
#  ##          ##  #
#  ##          ##  #
#  ##          ##  #
#  ##          ##  #
#  ##          ##  #
#  ##          ##  #
#  ########## ###  #
#                  #
####################
;